000----#-#-#---#-#-#-#-#-#------,
001--#-------#-------------#----,
002#---#-#-#---#-#-#-#-#-#------,
003--#-------#-------------#-#--,
004----#-#-#---#-#-#-#-#-#-----#,
005--#-------#-------------#----,
006----#-#-#---#-#-#-#-#-#-----#,
007--#-------#-------------#----,
008#---#-#-#---#-#-#-#-#-#-----#,
009--#--------------------------,
010#-----------#-#-#-#-#-#------,
011-----------------------------,
012#-----#-----#-#-----#-#------,
013--#-#------------------------,
014------------#-#-----#-#------,
100----#-#-----#-#-#-#-#-#------,
101---------#-------------------,
102-----#-#-----#-#------#------,
103---------#-------#-#---------,
104-------#-------#-----#-------,
105--#--------------#-#---------,
106----------------------------#,
107----------#------------------,
108----#---#-------------------#,
109------#----------------------,
110-----------------------------,
111-----------------------------,
112-----------------------------,
113-----------------------------,
114------------#-#-----#-#------,
200-----#-----------------------,
201-----------------------------,
202------#-#----#-#------#------,
203-----------------#-#---------,
204-------#-------#-----#-------,
205--#--------------#-#---------,
206-----------------------------,
207----------#------------------,
208--------#-------------------#,
209------#----------------------,
210-----------------------------,
211-----------------------------,
212-----------------------------,
213-----------------------------,
214------------#-------#--------,
300-----------------------------,
301-----------------------------,
302-------------#---------------,
303-----------------------------,
304---------------#-----#-------,
305-----------------#-#---------,
306-----------------------------,
307----------#------------------,
308-----------------------------,
309-----------------------------,
310-----------------------------,
311-----------------------------,
312-----------------------------,
313-----------------------------,
314-----------------------------,
400-----------------------------,
401-----------------------------,
402-------------#---------------,
403-----------------------------,
404---------------#-------------,
405-----------------------------,
406-----------------------------,
407-----------------------------,
408-----------------------------,
409-----------------------------,
410-----------------------------,
411-----------------------------,
412-----------------------------,
413-----------------------------,
414-----------------------------;